B B B B B B # # # R R R R R R
B H H H H B # 2 2 R H H H H R
B H b b H B # 2 # R H r r H R
B H b b H B # 2 # R H r r H R
B H H H H B # 2 # R H H H H R
B B B B B B # 2 # R R R R R R
# 1 # # # # F F F # # # # # #
# 1 1 1 1 1 F F F 4 4 4 4 4 #
# # # # # # F F F # # # # 4 #
Y Y Y Y Y Y # 3 # G G G G G G
Y H H H H Y # 3 # G H H H H G
Y H y y H Y # 3 # G H g g H G
Y H y y H Y # 3 # G H g g H G
Y H H H H Y 3 3 # G H H H H G
Y Y Y Y Y Y # # # G G G G G G