B B B B B B # # # R R R R R R
B H H H H B # R R R H H H H R
B H H H H B # R # R H H H H R
B H H H H B # R # R H H H H R
B H H H H B # R # R H H H H R
B B B B B B # R # R R R R R R
# B # # # # F F F # # # # # #
# B B B B B F F F G G G G G #
# # # # # # F F F # # # # G #
Y Y Y Y Y Y # Y # G G G G G G
Y H H H H Y # Y # G H H H H G
Y H H H H Y # Y # G H H H H G
Y H H H H Y # Y # G H H H H G
Y H H H H Y Y Y # G H H H H G
Y Y Y Y Y Y # # # G G G G G G