BBBBBB###RRRRRR
BHHHHB#RRRHHHHR
BHbbHB#R#RHrrHR
BHbbHB#R#RHrrHR
BHHHHB#R#RHHHHR
BBBBBB#R#RRRRRR
#B####FFF######
#BBBBBFFFGGGGG#
######FFF####G#
YYYYYY#Y#GGGGGG
YHHHHY#Y#GHHHHG
YHyyHY#Y#GHggHG
YHyyHY#Y#GHggHG
YHHHHYYY#GHHHHG
YYYYYY###GGGGGG